111111111111111111111111111111111
10000000C0000P0010000000000010001
10000000C000000000000000000010001
10000000C00010000000000000E010001
10000000C000000000100000000010001
111111111111111111111111111111111
