11111111111111111111111111111
1I0I000000I000000000000I00001
1000000C000CI0CCCCCC000000001
1000000C000C0000000C00000I001
1P00000CCCCCI0CCCCCC000I00001
10000I00000C00C0000000I000001
1I0I0000000CI0CCCCCC0000000E1
11111111111111111111111111111
