111111111111111111111111111111111
10000000C0000P0000000000000000001
10000000C000000000000000000000001
10000000C00000000000000000E000001
10000000C000000000000000000000001
111111111111111111111111111111111
