11111111111111111111111111111
1I0I000000I000000000000I10001
1000000C000CI0CCCCCC000010001
1100000C000C0000000C00001I001
1P00000CCCCC00CCCCCC000000001
11000000000C00C00000000000001
1I000000000C00CCCCCC000E10001
11111111111111111111111111111
