11111111111111111111111111111
100000I0000II000I000000010001
1000000C000CI0CCCCCC000010001
1100000C000C0000000C000010001
1P00000CCCCC00CCCCCC000000001
110000I0000CI0C0000000I000001
1000000000I000CCCCCC00I000001
1000000000I000000000000E00001
11111111111111111111111111111
