11111111111111111111111111111
10000000C00000001000000000001
10000000C00000000000000000001
10000000C00010000000000000E01
10000000C0000P000010000000001
11111111111111111111111111111
