11111111111111111111111111111
10000000000000000000000000001
1000000C000C00CCCCCC000000001
1000000C000C0000000C000000001
1P00000CCCCC00CCCCCC000000001
10000000000C00C00000000000001
10000000000C00CCCCCC0000000E1
11111111111111111111111111111
