11111111111111111111111111111
100000IIIIIIIIIIIIIIIIII10001
1000000C000C00CCCCCC000010001
1100000C000C0000000C000010001
1P00000CCCCC00CCCCCC000000001
11000000000C00C0000000I000001
1IIIIIIIIIIIIIIIIIIIII0E00001
11111111111111111111111111111
