11111111111111111111111
10000000C1100P000000001
1100000001E100000C00001
10000C00011000C00000001
100000C00100000C0000001
100C0000000000C00000001
11111111111111111111111
