111111111111111111
111111111111111111
10E000001000000001
10000P000000C00001
111111111111111111
