1111111111111111111111
1P00000000000000000001
10C0C0C0C0C0C0C0C0C0C1
1C0C0C0C0C0C0C0C0C0C01
10000000000000000000E1
1111111111111111111111
